°°°°°°°°°°°°°°°°°°°°°°°°°°°°°°°°°°°°°°°@°°°°°°°°°°°°°°°°°°°°°°°°°°°°°°°°°°°°°
°                                                                           °
°                                                                           °
°                                                                           °
°                                                                           °
°                                                                           °
°                                                                           °
°                                                                           °
°                                                                           °
°                                                                           °
°                                                                           °
°                                                      ý                    °
°                                                                           °
°                                                                           °
°                                                                           °
°                                                                           °
°                                                                           °
°                                                                           °
°                                                                           °
°                                                                           °
°                                                                           °
°                                                                           °
°                                                                           °
°                                                                           °
°                                                                           °
°                                                                           °
°                                                                           °
°                                                                           °
°                                                                           °
°°°°°°°°°°°°°°°°°°°°°°°°°°°°°°°°°°°°°°°°°°°°°°°°°°°°°°°°°°°°°°°°°°°°°°°°°°°°°