°°°°°°°°°°°°°°°°°°°°°°°°°°°°°°°°°°°°°°°@°°°°°°°°°°°°°°°°°°°°°°°°°°°°°°°°°°°°°
°                                                                           °
°                                                                           °
°                                                                           °
°                                                                           °
°                                                                           °
°                                                                           °
°                                     ý                                     °
°                                                                           °
°                                                                           °
°                                                                           °
°                                                                           °
°                                                                           °
°                                                                           °
°                                                                           °
°                                                                           °
°                                                                           °
°                                                                           °
°                                                                           °
°                     ý                                                     °
°                                                                           °
°                                                                           °
°                                                         ý                 °
°                                                                           °
°                                                                           °
°                                                                           °
°                                                                           °
°                                                                           °
°                                                                           °
°°°°°°°°°°°°°°°°°°°°°°°°°°°°°°°°°°°°°°°°°°°°°°°°°°°°°°°°°°°°°°°°°°°°°°°°°°°°°